99919069900060000609690
00906096069006099009060
06666660009000000966066
00009069996006099999696
60900609600696096096000
66006660096060696060900
09990690909609660996909
09090960969609900690666
60669699600660090066669
90669009066099696900962